wrrrrrrr    rrrrrrrw
w         e        w
w    e        e    w
wp  pppppppppppp  pw
w                  w
w                  w
wp  pppppppppppp  pw
w                  w
w                  w
wp  pppppppppppp  pw
w1                 w
pppppppppppppppppppp
