xxxxxxxxxxxxxxxxxxxx
x                  x
x         p        x
x     xxxxxxxx     x
x                  x
x   xxxxx  xxxxx   x
x                  x
x  e            e  x
xxxxxxxx    xxxxxxxx
x                  x
x  e          e    x
xxxxxxxxxxxxxxxxxxxx
