xxxxxxxx    xxxxxxxx
x         e        x
x    e        e    x
xx  xxxxxxxxxxxx  xx
x                  x
x                  x
xx  xxxxxxxxxxxx  xx
x                  x
x                  x
xx  xxxxxxxxxxxx  xx
xp                 x
xxxxxxxxxxxxxxxxxxxx
