wrrrrr  rrrr  rrrrrw
w    w        w    w
w    pp      pp    w
w e              e w
w ppppppp  ppppppp w
w we    w  w    ew w
w pp    w  w    pp w
w       w  w       w
w we            ew w
w ppppp  pp  ppppp w
wp                 w
wpppp  pppppp  ppppw
