xxxxxx  xxxx  xxxxxx
x  x  e      e  x  x
x  x xx      xx x  x
x  x  e      e  x  x
x  x xx      xx x  x
x  x            x  x
x                  x
x    xxxxxxxxxxx   x
x                  x
xxxx xx xxxx xx xxxx
xp                 x
xxxxxxxxxxxxxxxxxxxx
