rrrrrrrr    rrrrrrrr
w         e        w
w    e        e    w
pp  pppppppppppp  pp
w                  w
w                  w
pp  pppppppppppp  pp
w                  w
w                  w
pp  pppppppppppp  pp
w1                 w
pppppppppppppppppppp
