rrrrrr  rrrr  rrrrrr
w                  w
w  w    e  e    w  w
w  w  pppppppp  w  w
w                  w
w  w    f       w  w
w  w  pppppppp  w  w
w                  w
w  w e        e w  w
w  pppppp  pppppp  w
w1                2w
ppppp  pppppp  ppppp
