wrrrrr  rrrr  rrrrrw
w    w        w    w
w    pp      pp    w
w  e            e  w
w  ppppp   pppppp  w
w  we  w   w   ew  w
w  pp  w   w   pp  w
w      w   w       w
w  we          ew  w
w  pppp  pp  pppp  w
w1                2w
wpppp  pppppp  ppppw
