xxxxxx  xxxx  xxxxxx
x    x        x    x
x    xx      xx    x
x e              e x
x xxxxxxx  xxxxxxx x
x xe    x  x    ex x
x xx    x  x    xx x
x       x  x       x
x xe            ex x
x xxxxx  xx  xxxxx x
xp                 x
xxxxx  xxxxxx  xxxxx
