rrrrrr  rrrr  rrrrrr
w  w   e     e  w  w
w  w  pp     pp w  w
w  w   e     e  w  w
w  w  pp     pp w  w
w  w            w  w
w       f          w
w    ppppppppppp   w
w                  w
ppp  pp pppp pp  ppp
w1                2w
pppppppppppppppppppp
