xxxxxxxxxxxxxxxxxxxx
x                  x
xe        e       ex
xx  xxxxxxxxxxxx  xx
x                  x
x                  x
xx  xxxxxxxxxxxx  xx
x                  x
x                  x
xx  xxxxxxxxxxxx  xx
xp                 x
xxxxxxxxxxxxxxxxxxxx
