xxxxxx  xxxx  xxxxxx
x                  x
x x      e       x x
x x xxxxxxxxxxxxxx x
x                  x
x x     e        x x
x xxxxxxxxxxxxxx x x
x                  x
x x    e         x x
x xxxxxxx  xxxxxxx x
xp                 x
xxxxx  xxxxxx  xxxxx
