rrrrrrrr    rrrrrrrr
weeeeeeeeeeeeeeeeeew
w                  w
w                  w
w                  w
w                  w
w                  w
w                  w
w                  w
w                  w
w1                2w
ppp              ppp
