wrrrrr  rrrr  rrrrrw
w  p  e      e  p  w
w  p pp      pp p  w
w  p  e      e  p  w
w  p pp      pp p  w
w  p            p  w
w                  w
w    ppppppppppp   w
w                  w
wppp pp pppp pp pppw
w1                 w
wppppppppppppppppppw
