wrrrrr  rrrr  rrrrrw
w                  w
w p      e       p w
w p pppppppppppp p w
w                  w
w p     e        p w
w pppppppppppppp p w
w                  w
w p    e         p w
w ppppppp  ppppppp w
w1                 w
wpppp  pppppp  ppppw
