rrrrrrrr    rrrrrrrr
w                  w
w      e  f   e    w
pp  pppppppppppp  pp
w                  w
w                  w
pp  pppppppppppp  pp
w                  w
w                  w
pp  pppppppppppp  pp
w1            2    w
pppppppppppppppppppp
