rrrrrrrr    rrrrrrrr
w                  w
w      e      e    w
pp  pppppppppppp  pp
w                  w
w         f        w
pp  pppppppppppp  pp
w                  w
w      f           w
pp  pppppppppppp  pp
w1                2w
pppppppppppppppppppp
